NO ./texture/Stone1.xpm
SO ./texture/Stone2.xpm
WE ./texture/Stone3.xpm
EA ./texture/Metal1.xpm

F 0,50,90
C 10,100,255
111111111111111
100000000000001
100001100000001
100100001000001
100000000000001
100000000101001
101000000000001
100000000000001
100000000000001
1000000N0000001
111111111111111
