NO textures/spaceship_240/darkwall.xpm
SO textures/spaceship_240/lightedwall.xpm
WE textures/spaceship_240/metalstraf.xpm
EA textures/spaceship_240/rustedmetal.xpm

F 234,234,234
C 220,200,200

11111111
100000111111
1000000000001
10000001100E01
1000000000001
111111111111
