NO textures/bluewall.xpm
SO textures/greywall.xpm
WE textures/halo/forerunner900.xpm
EA textures/bluelight.xpm

F 192,192,192
C 15,14,49

        1                      11111111111111111111111111
                        111111100000000000000000000000001
111111111111111111111111100000000111111111111110011001001
100000000011000000000000000111111000000000000000011001001
100000000011000000000000100000000001111000000000011001001
100100000000000000000000111111111111111001111111111001001
1111111110110000011100001             1001   100000001001
100000000011000001110111111111111     1001   100000001001
111101111111110111000000000011111111111001111111111001001
111101111111110111010100000010000000000000000000011111001
110000001101010111000000100000000000010000010000010000001
100000000000000011000000100000000000000000000000010000001
100000000000000011010100100000000000000000000000010000001
110000011101010111110111100011100000010000010000010000001
11110111 1110101 101111010E01 100000000000000000000000001
11111111 1111111 111111111111 11111111111111111111111111
